. . . . . . . . 
. . . . . . . . 
* * . . . . . . 
. . * . . . . . 
. . . . . . . . 
. . * . . . . . 
. . . . * . * * 
. . . . . . * . 
